[
	[
		[ "w", "w", "w", "w", "e", "e", "w", "w", "w" ],
		[ "w", " ", " ", " ", " ", " ", "p", "M", "w" ],
		[ "w", "M", " ", " ", " ", " ", " ", "d", "w" ],
		[ "p", "d", " ", "p", "p", "p", " ", " ", "e" ],
		[ "w", " ", " ", " ", "W", "R", " ", " ", "w" ],
		[ "p", " ", " ", "p", "p", "p", " ", " ", "e" ],
		[ "w", " ", " ", " ", " ", " ", " ", " ", "w" ],
		[ "w", " ", " ", " ", "p", " ", " ", "C", "w" ],
		[ "w", "f", "w", "f", "w", "f", "w", "f", "w" ]
	],
	[
		[ "w", "w", "w", "w", "e", "e", "w", "w", "w" ],
		[ "w", "p", " ", " ", " ", " ", " ", "p", "w" ],
		[ "w", " ", " ", " ", " ", " ", " ", " ", "w" ],
		[ "w", " ", " ", "M", " ", "M", "M", " ", "e" ],
		[ "w", "M", " ", "d", "d", "d", "d", " ", "w" ],
		[ "w", " ", " ", "d", "d", "d", "d", " ", "e" ],
		[ "w", " ", " ", " ", "M", " ", " ", " ", "w" ],
		[ "w", " ", "p", " ", " ", " ", "p", " ", "w" ],
		[ "w", "w", "w", "f", "f", "f", "f", "w", "w" ]
	],
	[
		[ "w", "w", "w", "w", "e", "e", "w", "w", "w" ],
		[ "w", " ", "p", "w", " ", " ", "w", "M", "w" ],
		[ "w", " ", " ", "f", "M", " ", "f", "M", "w" ],
		[ "w", "W", " ", "f", "d", " ", "f", " ", "e" ],
		[ "w", "d", "d", "w", " ", " ", "w", " ", "w" ],
		[ "w", " ", " ", "w", " ", " ", "w", " ", "e" ],
		[ "w", " ", " ", " ", " ", " ", " ", " ", "w" ],
		[ "w", "p", "p", "w", "p", " ", "w", "p", "w" ],
		[ "w", "f", "f", "w", "f", "f", "w", "f", "w" ]
	]
]