/*
	M - Person,
	W - Walker,
	C - Cleaner,
	R - Robot

	c - Cooler,
	d - Desk,
	e - Elevator,
	p - Plant,
	s - Sofa,
	w - Wall,
	f - Window,
	space - Empty
*/

[
	[
		[ "w", "w", "w", "w", "e", "e", "w", "w", "w" ],
		[ "w", "p", "s", "s", " ", " ", "s", "c", "w" ],
		[ "w", "M", " ", " ", " ", " ", " ", " ", "w" ],
		[ "p", "d", " ", "p", "p", "p", " ", " ", "w" ],
		[ "w", " ", " ", " ", "W", "R", " ", " ", "e" ],
		[ "p", " ", " ", "p", "p", "p", " ", " ", "w" ],
		[ "w", " ", " ", " ", " ", " ", " ", " ", "e" ],
		[ "w", " ", " ", " ", "p", " ", " ", "C", "w" ],
		[ "w", "f", "w", "f", "w", "f", "w", "f", "w" ]
	],
	[
		[ "w", "w", "w", "w", "e", "e", "w", "w", "w" ],
		[ "w", "p", " ", "c", " ", " ", " ", "p", "w" ],
		[ "w", " ", " ", " ", " ", " ", " ", " ", "w" ],
		[ "w", " ", " ", "M", " ", "M", "M", " ", "w" ],
		[ "w", "M", " ", "d", "d", "d", "d", " ", "e" ],
		[ "w", " ", " ", "d", "d", "d", "d", " ", "w" ],
		[ "w", " ", " ", " ", "M", " ", " ", " ", "e" ],
		[ "w", "c", "p", " ", " ", " ", " ", " ", "w" ],
		[ "w", "w", "w", "f", "f", "f", "f", "w", "w" ]
	],
	[
		[ "w", "w", "w", "w", "e", "e", "w", "w", "w" ],
		[ "w", " ", "p", "w", " ", " ", "w", "c", "w" ],
		[ "w", " ", " ", "f", "M", " ", "f", "M", "w" ],
		[ "w", "W", " ", "f", "d", " ", "f", " ", "w" ],
		[ "w", "d", "d", "w", " ", " ", "w", " ", "e" ],
		[ "w", " ", " ", "w", " ", " ", "w", " ", "w" ],
		[ "w", " ", " ", " ", " ", " ", " ", " ", "e" ],
		[ "w", "p", "p", "w", "p", "p", "w", "p", "w" ],
		[ "w", "f", "f", "w", "f", "f", "w", "f", "w" ]
	]
]
